Date,Day of the week,CarCount,BikeCount,BusCount,TruckCount,Total
10,Tuesday,31,0,4,4,39
10,Tuesday,49,0,3,3,55
10,Tuesday,46,0,3,6,55
10,Tuesday,51,0,2,5,58
10,Tuesday,57,6,15,16,94
10,Tuesday,44,0,5,4,53
10,Tuesday,37,0,1,4,42
10,Tuesday,42,4,4,5,55
10,Tuesday,51,0,9,7,67
10,Tuesday,34,0,4,7,45
10,Tuesday,45,0,1,1,47
10,Tuesday,45,0,1,3,49
10,Tuesday,50,0,3,0,53
10,Tuesday,34,0,4,4,42
